NO ./texture/lava_black.xpm
SO ./texture/lava_purple.xpm
WE        ./texture/new_world.xpm
EA ./texture/bookshelf.xpm
C 255,97,250
F     255,56,34





1111111111
1111111111111111111111111
100000000110000000000001
1011000001110000000000001
1001000000000000000000001
11111111111100000111000001
100000000011000001110111111111111
11110111111111011100000010001
11110111111111011101010010001
1100000011010101110000010001
100000000000N0001100000000001
10000000000000001101010010001
11000001110101011111011110001
11110111 1110101 11111010001
11111111 1111111 111111111111