NO ./texture/lava_black.xpm
SO ./texture/lava_purple.xpm
WE        ./texture/fire.xpm
EA ./texture/lava_red.xpm
C 255,97,250
F     255,56,34





1111111111
1111111111111111111111111
1111111111
1111111111111111111111111
100000000110000000000001
1011000001110000000000001
100100000000000000000000111111111111111111
111111111111000001110000000000000000000001
100000000011000001110111111111111010001101
111101111111110111000000100000000000000001
111101111111110111010100100011000000111101
110000001101010111000001000110011100111101
10000000000000001100000000S01001110101100111
10000000000000000101010010000001000101110001
11000001110101010111011110001111000000000001
1111000111011011111010000111111111111111111
111100011111100111111111111
100000000110000000000001
1011000001110000000000001
1001000000000000000000001
11111111111100000111000001
100000000011000001110111111111111
11110111111111011100000010001
11110111111111011101010010001
1100000011010101110000010001
10000000000000001100000000001
10000000000000001101010010001
11000001110101011111011110001
11110111 1110101 11111010001
11111111 1111111 111111111111