111111111111
1000001000N1
110100011001
111 111  111
1 1 111  111
