111111 11111
10W000100001
110100011001
111 111  111
1 1 111  111
