NO ./path_to_the_north_texture
SO ./path_to_the_south_texture
WE        ./path_to_the_west_texture
EA ./path_to_the_east_texture

F     255,56,34

C 255,97,250



1111111111
1111111111111111111111111
100000000110000000000001
1011000001110000000000001
1001000000000000000000001
11111111111100000111000001
100000000011000001110111111111111
11110111111111011100000010001
11110111111111011101010010001
1100000011010101110000010001
10000000000000001100000000001
10000000000000001101010010001
11000001110101011111011110001
11110111 11101S1 11111010001
11111111 1111111 111111111111