1111111111111
1000000000001
1111110000001
1111111100001
1100000000111
1100000N00001
1100000110001
1111111111111